11111111111111
10001100000P01
1C000100011001
1E000000001001
10000010000011
10000010000011
10000010000011
10000010000011
10000010000011
10000010000011
10000010000011
10000010000011
10000010000011
11111111111111