1111111111111111111111
1000000000000000000001
100000000000E111111001
1000000000000110000001
10000P000000011C000001
1111111111111111111111