11111111111111
1C00C1C10101C1
10C0010101C101
1C000101010101
11100000000001
1P000000000001
11111111111111