11111111111111111111111111111
100000000000000000000000000C1
10011111111111111111111111111
100000000000000000000000000C1
10011111111111111111111111111
100000000000000000000000000C1
111111111111111111111111100C1
100000000000000000000000000C1
10000111111111111111111110001
10P011E0000000000000000000001
11111111111111111111111111111