111111111111111111111111111111
1000000000000000000000000000C1
100111111111111111111111111111
1000000000000000000000000000C1
100011111111111111111111111111
1000000000000000000000000000C1
1111111111111111111111111100C1
1000000000000000000000000000C1
100000111111111111111111110001
100P011E0000000000000000000001
111111111111111111111111111111