1111111111111
10000000000C1
10000000000C1
10000000000C1
100000P0000C1
10000000000C1
10000000000C1
10000000000C1
1000011111001
100011E000001
1111111111111